{
    M : [
        "===================================",
        "=E       E          D       #    H=",
        "=##&#  ##&#  ###&&  &#&#  &##  #&&=",
        "=     E#      &   #       &    #  =",
        "=##&  #  ##  #E  #  ###  #  #  # #=",
        "=   &  #  #   #   #     #    &    =",
        "=# # #&& #  &###  #&&  ##&#  #  # =",
        "=#   & #   E     #               D=",
        "=##  E    ###  #  ##&##  &&#&  ##&=",
        "=#  ### ##    #    #      #       =",
        "=#  #E   #  #  ##&  &##  #  ##  &#=",
        "=   &###&# #    #    #    &   E  &=",
        "=&##&##&&##  ###&  &  #### ###& ##=",
        "=         &  #            &     D =",
        "=            #     ####  #  #&#  #=",
        "=####&#&####&&      #    #       #=",
        "=#  #&#&  &&##&  ####  #&#  &#### =",
        "=&  #        #       #      &     =",
        "=##  ##&  ###  &##  ####&#  #&# &#=",
        "=#    #       #    #    #       E =",
        "=####  #####  ##&  #  &&&  #### ##=",
        "=     &    #     H     #         #=",
        "=###  #  ##  &#####  &  ##&  #&## =",
        "= #   #   #  &       &    #       =",
        "= # ###&  ##  ###  #&#&  &&#&  & #=",
        "=#  #        #    #      #       #=",
        "=#&  &##  ###  &#  ##&&  &&##  &# =",
        "=#    #       #          E      # =",
        "=####  &##&  #&#&  #&&#  &#&#  ###=",
        "=D           #            #      E=",
        "==================================="
    ]
}